8,5,5,5,5,5,5,17
7,4,4,4,4,4,4,16
7,0,0,0,0,0,0,16
7,0,0,0,0,0,0,16
7,0,0,0,0,0,0,16
7,0,0,0,0,0,0,16
7,0,0,0,0,0,0,16
7,0,0,0,0,0,0,16
9,6,6,6,11,6,6,18
