13,0,1,1,1,1,2,6
11,3,4,4,4,4,5,7
11,12,12,12,12,12,12,7
11,12,12,12,12,12,12,7
11,12,12,12,12,12,12,7
11,12,12,12,12,12,12,7
11,12,12,12,12,12,12,7
11,12,12,12,12,12,12,7
8,9,9,9,9,12,9,10
